11111111111111111111111111111111111111111
10000000000000010010000000010000000100001
10000000000000010010000000010000000100001
10000000000000011110000000010000000100001
10000000000000000010000000010000000100001
10000000000000000010000000010000000100001
10000000000000000011111111110000000111111
11111000000000000010000000000000000000001
10000000000000000010000000010000000000001
10000000000000000010000000010000000000001
10000000000000100010000000010000000000001
10000000000000100010000000010000000000001
10000000000000100010000000010000000000001
10000000111111100000000000010000000011111
10000000000000100000000000010000000000001
10000000000001100000000000010000000000001
10000000000000100000000000010000000000001
10000000000001100000000000010000000000001
10000000000000000000000000000000000000001
10000000000000000000000000000000000000001
11111111111111111111111111111111111111111
